57 57 57 57 57 57 57 57 57 57 57 57 57 57 57 57 57 57 57 57 57 57 57 57 57 57 57 57 57 57 57 57 57 57 57 57 57 57 57 57 57 57 57 57 57 57 57 57 57 57
57 57 57 57 57 57 57 57 57 57 57 57 57 57 57 57 57 57 57 57 57 57 57 57 57 57 57 57 57 57 57 57 57 57 57 57 57 57 57 57 57 57 57 57 57 57 57 57 57 57
57 57 57 57 57 57 57 57 57 57 57 57 57 57 57 57 57 57 57 57 57 57 57 57 57 57 57 57 57 57 57 57 57 57 57 57 57 57 57 57 57 57 57 57 57 57 57 57 57 57
57 57 57 57 57 57 57 57 57 57 60 60 58 58 58 58 58 58 58 58 58 58 58 58 58 58 58 58 58 58 58 58 58 58 58 58 58 58 58 58 58 60 60 57 57 57 57 57 57 57
57 57 57 57 57 57 57 57 57 57 60 60 58 58 58 58 58 58 58 58 59 58 58 58 58 58 58 58 58 58 58 58 58 58 58 58 58 58 58 58 58 60 60 57 57 57 57 57 57 57
57 57 57 57 57 57 57 57 57 57 57 60 60 58 58 58 58 58 58 58 58 58 59 58 58 58 58 58 58 58 58 58 58 58 58 58 58 58 58 58 60 60 57 57 57 57 57 57 57 57
57 57 57 57 57 57 57 57 57 57 57 57 60 60 58 58 58 58 58 58 58 58 58 58 59 61 61 61 61 61 61 61 61 61 61 61 61 61 61 60 60 57 57 57 57 57 57 57 57 57
57 57 57 57 57 57 57 57 57 57 57 57 57 57 60 60 58 58 58 58 58 58 58 58 58 61 61 61 61 61 61 61 61 61 61 61 61 61 61 57 57 57 57 57 57 57 57 57 57 57
57 57 57 57 57 57 57 57 57 57 57 57 57 57 57 60 60 58 59 58 58 58 58 58 58 61 61 61 61 61 61 61 61 61 61 61 61 61 57 57 57 57 57 57 57 57 57 57 57 57
57 57 57 57 57 57 57 57 57 57 57 57 57 60 60 58 58 58 58 58 58 58 58 58 58 61 61 61 61 61 61 61 61 61 61 61 61 61 61 60 57 57 57 57 57 57 57 57 57 57
57 57 57 57 57 57 57 57 57 57 57 57 57 57 60 60 58 58 58 58 58 58 58 58 58 61 61 61 61 61 61 61 61 61 61 61 61 61 61 57 57 57 57 57 57 57 57 57 57 57
57 57 57 57 57 57 57 57 57 57 57 57 57 57 57 60 60 58 58 58 58 58 58 58 58 61 61 62 61 61 61 61 61 61 61 61 61 61 57 57 57 57 57 57 57 57 57 57 57 57
57 57 57 57 57 57 57 57 57 57 57 57 57 57 60 60 58 58 58 58 58 58 58 58 58 61 61 61 61 61 61 61 61 59 59 59 59 57 57 57 57 57 57 57 57 57 57 57 57 57
57 57 57 57 57 57 57 57 57 57 57 57 57 57 60 60 58 58 58 59 58 58 58 58 58 61 61 61 61 61 61 61 61 59 59 59 59 57 57 57 57 57 57 57 57 57 57 57 57 57
57 57 57 57 57 57 57 57 57 57 57 57 57 60 60 58 58 58 60 60 60 60 60 60 60 61 61 61 61 61 61 59 59 59 59 59 59 61 57 57 57 57 57 57 57 57 57 57 57 57
57 57 57 57 57 57 57 57 57 57 57 57 57 57 60 60 58 62 58 58 58 58 58 58 58 61 61 61 61 59 59 59 59 59 59 59 61 57 57 57 57 57 57 57 57 57 57 57 57 57
57 57 57 57 57 57 57 57 57 57 57 57 57 60 60 58 58 58 58 58 58 58 58 58 58 59 58 59 59 59 59 59 59 59 60 60 57 57 57 57 57 57 57 57 57 57 57 57 57 57
57 57 57 57 57 57 57 57 57 57 57 57 57 57 60 60 58 58 58 58 58 58 58 58 59 58 58 59 59 59 59 59 59 60 60 57 57 57 57 57 57 57 57 57 57 57 57 57 57 57
57 57 57 57 57 57 57 57 57 57 57 57 57 57 57 60 60 60 60 60 60 60 58 58 58 58 58 59 59 59 59 59 60 60 57 57 57 57 57 57 57 57 57 57 57 57 57 57 57 57
57 57 57 57 57 57 57 57 57 57 57 57 57 57 57 57 60 60 58 58 58 58 58 58 58 58 58 63 63 63 63 60 60 57 57 57 57 57 57 57 57 57 57 57 57 57 57 57 57 57
57 57 57 57 57 57 57 57 57 57 57 57 57 57 57 57 57 60 60 58 58 58 58 58 58 59 59 59 63 63 60 60 57 57 57 57 57 57 57 57 57 57 57 57 57 57 57 57 57 57
57 57 57 57 57 57 57 57 57 57 57 57 57 57 57 57 57 57 60 60 58 58 59 59 59 59 59 59 63 60 60 57 57 57 57 57 57 57 57 57 57 57 57 57 57 57 57 57 57 57
57 57 57 57 57 57 57 57 57 57 57 57 57 57 57 57 57 57 58 58 58 58 59 59 59 59 59 59 59 60 60 57 57 57 57 57 57 57 57 57 57 57 57 57 57 57 57 57 57 57
57 57 57 57 57 57 57 57 57 57 57 57 57 57 57 57 57 57 58 58 58 58 58 59 59 59 59 58 58 60 60 57 57 57 57 57 57 57 57 57 57 57 57 57 57 57 57 57 57 57
57 57 57 57 57 57 57 57 57 57 57 57 57 57 57 57 57 60 58 58 58 58 58 63 63 63 59 58 58 58 60 60 57 57 57 57 57 57 57 57 57 57 57 57 57 57 57 57 57 57
57 57 57 57 57 57 57 57 57 57 57 57 57 57 57 57 60 60 58 58 58 58 58 63 63 63 59 59 59 59 58 60 60 57 57 57 57 57 57 57 57 57 57 57 57 57 57 57 57 57
57 57 57 57 57 57 57 57 57 57 57 57 57 57 57 60 60 58 58 58 58 58 58 63 63 63 59 59 59 59 59 59 58 58 60 60 57 57 57 57 57 57 57 57 57 57 57 57 57 57
57 57 57 57 57 57 57 57 57 57 57 57 57 57 60 60 58 58 58 58 58 58 58 58 58 59 59 59 59 59 59 59 58 58 58 58 58 57 57 57 57 57 57 57 57 57 57 57 57 57
57 57 57 57 57 57 57 57 57 57 57 57 60 60 58 58 58 59 58 58 58 58 58 58 58 58 58 58 59 59 59 59 58 58 59 59 59 58 58 57 57 57 57 57 57 57 57 57 57 57
57 57 57 57 57 57 57 57 57 57 57 60 60 58 58 58 58 58 58 62 58 58 58 58 58 58 58 58 63 63 63 63 58 58 59 59 59 58 58 60 57 57 57 57 57 57 57 57 57 57
57 57 57 57 57 57 57 57 57 57 57 57 60 60 60 60 60 60 60 60 60 60 60 58 58 58 58 58 63 63 63 59 59 59 59 59 59 58 58 60 60 57 57 57 57 57 57 57 57 57
57 57 57 57 57 57 57 57 57 57 57 57 60 60 58 58 58 58 58 58 58 58 58 58 58 58 58 58 63 63 63 59 59 59 59 59 59 58 58 60 60 57 57 57 57 57 57 57 57 57
57 57 57 57 57 57 57 57 57 57 57 57 60 60 58 58 58 58 58 58 58 58 58 58 58 58 58 58 58 59 59 59 59 59 59 59 59 58 58 60 60 57 57 57 57 57 57 57 57 57
57 57 57 57 57 57 57 57 57 57 57 57 60 60 58 58 58 58 58 58 58 58 58 59 59 59 59 59 59 59 59 59 59 59 58 58 58 58 58 60 60 57 57 57 57 57 57 57 57 57
57 57 57 57 57 57 57 57 57 57 57 57 60 60 58 58 58 58 58 58 58 62 59 59 59 59 59 59 59 59 59 59 59 58 58 58 59 58 58 60 60 57 57 57 57 57 57 57 57 57
57 57 57 57 57 57 57 57 57 57 57 57 60 60 58 58 58 58 58 59 59 59 59 59 59 59 59 59 59 59 59 58 58 58 58 58 58 58 58 60 60 57 57 57 57 57 57 57 57 57
57 57 57 57 57 57 57 57 57 57 57 60 60 58 59 58 59 59 59 59 59 59 59 59 59 59 59 59 59 59 59 58 58 58 58 58 62 58 58 58 60 60 57 57 57 57 57 57 57 57
57 57 57 57 57 57 57 57 57 57 60 60 58 58 58 59 59 59 59 59 59 59 59 59 59 59 59 58 58 58 58 58 58 58 58 58 58 58 58 58 59 60 60 57 57 57 57 57 57 57
57 57 57 57 57 57 57 57 57 60 60 58 62 59 58 59 59 59 59 59 59 58 58 58 58 58 58 58 58 58 58 58 58 58 58 58 58 58 58 58 58 58 60 60 57 57 57 57 57 57
57 57 57 57 57 57 57 60 60 58 58 58 58 58 59 59 59 59 58 58 58 58 58 58 58 58 58 58 58 58 62 58 58 58 58 58 58 58 58 58 58 58 60 60 57 57 57 57 57 57
57 57 57 57 57 57 57 57 60 60 58 58 59 59 59 59 59 59 58 58 58 58 58 58 58 58 59 58 58 58 58 58 58 58 58 58 58 58 58 58 62 60 60 57 57 57 57 57 57 57
57 57 57 57 57 57 57 57 60 60 58 58 59 59 59 59 59 58 58 58 58 59 59 58 58 58 58 58 58 58 58 58 58 58 58 58 58 58 58 58 58 60 60 57 57 57 57 57 57 57
57 57 57 57 57 57 57 57 60 60 58 58 58 59 59 59 58 60 60 60 60 60 60 60 60 58 58 59 58 58 58 58 58 59 58 58 58 58 58 58 58 60 60 57 57 57 57 57 57 57
57 57 57 57 57 57 57 57 57 60 58 58 59 58 59 58 58 58 58 62 58 58 58 58 58 58 58 58 58 59 58 58 58 58 58 58 58 58 58 58 60 60 57 57 57 57 57 57 57 57
57 57 57 57 57 57 57 57 57 60 58 58 58 58 58 58 58 58 58 58 58 58 58 58 58 58 58 58 58 58 58 58 58 58 58 58 58 58 60 60 57 57 57 57 57 57 57 57 57 57
57 57 57 57 57 57 57 57 57 57 57 60 60 58 58 58 58 58 58 58 58 58 58 58 58 58 58 58 58 58 58 58 58 58 58 58 60 60 57 57 57 57 57 57 57 57 57 57 57 57
57 57 57 57 57 57 57 57 57 57 57 57 57 60 60 58 58 58 58 58 58 58 58 58 58 58 58 58 58 58 58 58 58 58 60 60 57 57 57 57 57 57 57 57 57 57 57 57 57 57
57 57 57 57 57 57 57 57 57 57 57 57 57 57 57 57 57 57 57 57 57 57 57 57 57 57 57 57 57 57 57 57 57 57 57 57 57 57 57 57 57 57 57 57 57 57 57 57 57 57
57 57 57 57 57 57 57 57 57 57 57 57 57 57 57 57 57 57 57 57 57 57 57 57 57 57 57 57 57 57 57 57 57 57 57 57 57 57 57 57 57 57 57 57 57 57 57 57 57 57
57 57 57 57 57 57 57 57 57 57 57 57 57 57 57 57 57 57 57 57 57 57 57 57 57 57 57 57 57 57 57 57 57 57 57 57 57 57 57 57 57 57 57 57 57 57 57 57 57 57
